20
10

####################
#                  #
#   B              #
#                  #
#             D    #
#                  #
#     O            #
#         M        #
#                  #
####################